10
G.-.G.S.-.-.-.-.-.-
-.-.S.W.S.G.-.B.-.G
-.G.-.S.-.-.B.P.B.-
-.-.B.-.G.-.-.B.-.-
-.B.P.B.-.-.-.-.-.G
S.-.B.-.A.-.-.B.G.-
W.S.-.-.-.B.B.P.BS.-
S.G.B.-.B.P.B.BS.W.S
-.B.P.B.-.B.S.W.S.G
-.G.BG.-.-.-.-.S.-.G
