10
G.-.-.B.P.B.-.-.B.P
-.S.-.G.B.-.-.-.G.B
S.W.S.-.-.-.G.B.-.-
-.S.B.-.-.-.B.P.B.-
-.B.P.B.-.-.-.B.-.G
B.G.B.-.A.-.B.-.-.B
P.B.-.-.-.B.P.B.B.P
B.-.G.-.-.-.B.-.G.B
G.-.-.-.G.-.-.-.-.B
-.-.-.-.-.-.-.-.B.P
