10
G.S.G.G.G.G.S.G.G.G
S.W.S.G.G.S.W.S.G.G
G.S.G.G.G.G.S.G.G.G
G.S.G.G.S.G.G.G.S.G
S.W.S.S.W.S.G.S.W.S
G.S.G.G.S.G.G.G.S.G
G.G.G.G.G.S.G.G.G.G
G.G.S.G.S.W.S.A.G.G
G.S.W.S.G.S.G.G.G.G
G.G.S.G.G.G.G.G.G.G
